1-Small battlefield 
MaxSteps = 5000 
NumShells=20 
Rows = 20 
Cols =15 
###############
#1  @2  ### 1 #
# ### ### ##  #
#   #   #     #
### ### # ### #
#     #  #    #
# ### #### ## #
# #   #      ##
# ### ### ### #
#   #      #  #
#### # #### # #
#    #  @   # #
# ## #### ##  #
#1  ##    ## 2#
###############